0,0,0,1,1,2,6,2,2,2,2,7,7
0,0,0,1,1,2,6,2,2,2,2,7,7
0,0,0,1,1,2,6,2,2,2,2,7,7
0,0,0,0,1,2,6,2,2,2,2,7,7
0,0,0,0,1,2,6,6,6,6,6,7,7
0,0,0,0,1,2,2,2,2,2,6,7,7
4,0,0,0,1,1,1,1,1,2,6,7,7
3,3,0,0,0,0,0,0,1,2,6,7,7
3,3,0,0,0,0,0,0,1,2,6,7,7
4,0,0,0,0,0,0,0,1,2,6,7,7
0,0,0,0,0,0,0,0,1,2,6,7,7
0,0,0,0,0,0,0,0,1,2,6,7,7
7,7,7,7,7,7,7,7,7,7,7,7,7
7,7,7,7,7,7,7,7,7,7,7,7,7
7,7,7,7,7,7,7,7,7,7,7,7,7
